Deities: 
    
Dwarven Pantheon
    Moradin - king, LG
    Arbjor - NE, greed
    Njarberra - Queen, family, LG
    Gjeddin - War, LG
    Duerra - Evil, LE
    Mjorin - Lore, CG
    Thoine - Secrets, N
    Gormstang - Protection, LG
    Haela - Victory, CG
    LaDuguer - Ultimate Evil (The Devil), NE
    Mjirhammer - Travel, NG
    Sharinjar - Mercy, CG
    Jard - Wilderness, CG
    Verjoine - Wealth/Merchants, N
    
Elven Pantheon
    Corethian Sunblade- King, CG; Domains: Chaos[Whimsy], Good, Sun[Thirst], War[Duels]
    Sehanine Moonbow - Queen, CG; Domains: Chaos, Good, Darkness[Moon], Luck[Fate]
    Aerdie - Winged Creatures, CG; Domains: Chaos, Good, Air[Wind], Animal[Feather]
    Aeharad - Life/Fertility, CG; Domains: Chaos, Good[Friendship], Healing[Restoration], Charm[Love]
    Sahaelis - Oceans, CG; Chaos, Good, Water[Oceans], Weather[Storms]
    Ereven - Dance/Parties, CN; Chaos[Revelry], Nobility[Aristocracy], Charm[Lust], Trickery[Innuendo]
    Fenaril - Wilderness, CN; Chaos, Air[Clouds], Travel[Exploration], Liberation[Self-Realization], 
    Celanil - Artistry/Love, CG; Chaos, Good, Charm[Love, Lust], Artifice
    Labelas - Time, CG; Chaos[Entropy], Good, Knowledge[Memory], Darkness[Moon]
    Rillifen - Druids, NG ; Domains: Air, Earth, Fire, Water
    Shavarash - The Hunt, CG; Destruction[Hatred], Death[Murder], War[Tactics], Trickery[Ambush]
    Solonor - War, CG; Domains: Glory[Legend], Good[Redemption], War[Duels], Protection[Defense]
    Aelstilae - good drow, CG: Domains: Void[Isolaton], Earth[Caves], Darkness[Loss], Liberation[Revolution]
        Drow: 
            Lolth - ex-Queen, evil, CE
            Aekiarlee - undead, CE
            Maetelis - bodyguard of Lolth, LE
            Vhaern - male drow, CE

Halfling Pantheon
    Arvoreen - Hunt, CG
    Brandobaris - Play, CG
    Cyrrollalee - Travel, CG
    Peryoyl - Trickery, CG
    Urogalan - evil halflings, CE
    Yondalla - Queen, CG

Gnomish Pantheon
    Garl Glittergold - King, NG
    Baervan Wildwanderer - Travel, NG
    Baravar Cloakshadow - Illusions, CG
    Callarduran Smoothands - Svirfneblin, N
    Flandal Steelskin - Paladins, LG
    Gaerdal Ironhand - Invention, LN
    Segojan Earthcaller - Druids, N
    Urdlen - Evil gnomes, NE

Orcish Pantheon
    Gruumsh - King, CE
    Bahgtru - Strength, CE
    Ilneval - War, NE
    Luthic - female orcs, NE
    Shargaas - thieves, CE
    Yurtrus - Disease, NE 
    
Human Pantheons
   LG Sola - Day ; Domains: Good, Law, Glory[Honor] , Sun[Day]
   CG Noxa - Night; Domains: Chaos, Good, Darkness[Night], Void[Stars]
   CN Caelis - Sky; Domains: Chaos, Weather[Seasons], Air, Travel[Exploration]
   LN Saxon - Earth ; Domains: Law, Animal, Earth[Caves, Metal], Strength[Resolve]
   N Sylvanus - Woodlands / Plants; Domains: Plant[Thorns], Water[Rivers], Erosion, Liberation[Freedom]
   LN Russo - Farming; Domains: Law, Plant[Growth], Community[Family], Artifice[Toil]
   CN Pecunia - Merchants; Domains: Chaos, Travel[Trade], Trickery[Greed], Charm[Captivation]
   NE Venecus - Evil Magic / Undeath & Death; Domains: Evil, Repose[Souls], Death[Undead], Luck[Curse]
   NG Luxi - Light / Good magic; Domains: Good, Sun[Light, Revelation], Magic[Divine], Protection[Purity]
   LN Ientus - Knowledge; Domains: Law, Knowledge[Education], Healing[Medicine], 
   LE Rabelus - War; Domains: Law, Evil, Glory[Heroism], War[Blood]
   CG Arakis - Aristry / Craftsmen; Domains: Good, Chaos, Artifice, Community[Cooperation]
